1 1 1 1  1  1  1  1  1  1  1  1  1  1  1  1  1  1  1  1 
1 0 0 0  0  0  0  0  0  0  1  0  0  0  0  0  0  1  0  100 
1 0 0 1  0  0  0  0  0  0  1  0  0  0  0  0  0  1  0  100 
1 0 1 1  1  1  1  1  1  0  1  0  1  0  1  1  0  1  0  1 
1 0 0 0  1  0  0  0  0  0  1  1  1  0  1  0  0  0  0  1 
1 1 1 0  1  0  1  0  1  1  1  0  0  0  1  0  0  1  1  1 
1 0 0 0  1  0  0  0  1  0  1  0  1  1  1  1  1  1  0  1 
1 1 1 0  1  8  0  0  1  0  0  8  0  1  0  0  0  1  0  1 
1 0 0 0  1  1  1  1  1  1  0  1  0  1  0  1  0  1  0  1 
1 0 1 1  1  0  0  0  1  0  0  1  0  1  0  1  0  1  0  1 
1 0 0 0  0  0  1  0  1  0  1  1  1  1  0  1  0  1  0  1 
1 1 0 0  1  1  1  0  1  0  0  0  0  0  0  1  0  0  0  1 
1 0 0 8  0  1  0  0  1  0  1  1  0  1  1  1  1  1  0  1 
1 0 1 1 1  1  0  1  1  0  0  1  0  1  1  0  0  1  0  1 
1 0 0 0 1  1  0  1  1  1  1  1  8  0  0  0  0  1  1  1 
1 1 1 0 1  0  0  1  0  0  0  1  1  1  1  1  0  0  0  1 
1 0 0 0 1  0  1  1  0  1  0  1  0  0  0  1  1  0  1  1 
1 0 1 0 0  0  8  0  2  1  0  0  0  1  0  0  0  0  0  1 
1 0 1 1 0  1  0  1  0  1  0  1  0  1  0  1  0  1  0  1 
1 10 1 1  1  1  1  1  1  1  1  1  1  1  1  1  1  1  1  1 